0;0;0;STONE;
0;1;0;STONE;
0;2;0;WATER;
0;3;0;WATER;
0;4;0;WATER;
