0;0;0;STONE;
0;1;0;STONE;
0;2;0;STONE;
0;3;0;STONE;
0;4;0;STONE;
0;5;0;STONE;
0;6;0;STONE;
0;7;0;STONE;
0;8;0;STONE;
